// 出現時間　出現座標(x,y)　速度(vx,vy)　HP　防御力　弾発射間隔　弾タイプ 弾速度
// 初期編隊
50,300,50,0,0,1000,5,10,1,8

// 第二編隊

// 第三編隊

//　第四編隊

//　第五編隊

// 第六編隊

// 第七編隊

// 第八編隊

// 第九編隊
800,100,0,0,8,20,5,30,1,10
805,100,0,0,8,20,5,20,1,15
810,100,0,0,8,20,5,10,1,8
815,100,0,0,8,20,5,20,1,15
800,380,640,0,-8,20,5,10,1,8
805,380,640,0,-8,20,5,20,1,10
810,380,640,0,-8,20,5,30,1,15
815,380,640,0,-8,20,5,20,1,10

// ボス
*